101111111111111
100001000000001
101101011111101
100001010000001
111101010111101
100000010100001
101111010101111
101000000100001
101011111101101
101000000001101
111111011101101
100000010010001
101111111111101
100001000000001
111111111111101